*****-----**-***
**+**-----------
**+**-----***=*-
**+++AAAAA++++*B
----------------
----------------

P 7 0
X 2 1
a 12 0 5 2 1
b 0 5 15 5 1
b 0 5 15 5 1