*******************
******--P--**a*****
***X**-----------**
***+**$----***=*-**
*--A-/++         **
*--A-/++         **
*--A-/++         **
*******************

P 1 1
X 1 3
a 1 2 6 2 1